9800000000000000004000000000000000000000000000000000000000000000000000000000000000000000000000000000000000000000000000000000000000000000000000000000000000000000000000000000
4100000000000000004000000000000000000000000000000000000000000000000000000000000000000000000000000000000000000000000000000000000000000000000000000000000000000000000000000000
41000000dddd000000cbb0000000000000000000004511111111111000000000000000000000000000000000000000000000000000000000000000000000000000000000000000000000000000000000000000000000
418888500000000000000cb10000000000000000004500000000000000000000000000000000000000000000000200000000000000000000000000000000000000000000000000000000000000000000000000000000
41111112250000000000000cbb10000000000000004500000000000000000000000000000000000000023212000000030000000000000000000000000006000000000000000000000000000000000111000011100000
41131111112250000000000000cbb10000000000004500000000000000000000000000000021122000000000000000000000211120000000000000000007000000022220000001111000001000011000100100011000
411111311111122500000000000004111000000000450000000000988888888888888a000000000000000000000000000000000000000008888888888888888000000000000001000110001000110000011000001100
4111111121111111225000000000000041110000004511200000004111111111111115000000000000000000000000000000000000000004111111211111111000000000000001000011001000001100000000011000
411211311112111111122500000d000000041110004500000000004111112111111115000000000000000000000000000000000000000000411111113111211000000000000001000111001000000011000001100000
4111121111111111111111225000000000000041114500000001314111111111111115000000000000000000000000000000000000000000000000411113111000000000000001000110001000000000100010000000
411111111111131111111111122500000000000000450dd00000004111311111311115000000000000000000000000000000000000000000000000000000411000000000000001111000001000000000011100000000
4111111111113131111111111111225000000000004512100000004111111121111115000000000000000000000000000000000000000000000000000000000000000000000000000000000000000000001000000000
4111111111111111111111111111111225000000000000000000004111111111111115000000000000000000000000000000000000000000000000000000000000000000000000000000000000000000000000000000
4111111111111111111111111111111111225000000000000002224111111111111115000000000000000000000000000000000000000000000000000000000000000000000000000000000000000000000000000000
4111111111111111111111111111111111111225000ddddd0000004111111111111115000000000000000000000000000000000000000000000000000000000000000000000000000000000000000000000000000000
4111111111111111111111111111111111111111588888888888884111311111111115000000000000000000000000000000000000000000000000000000000000000000000000000000000000000000000000000000
4111111111111111111111111111111111111111111311111113111111111111111115000000000000000000000000000000000000000000000000000000000000000000000000000000000000000000000000000000
